10 x 20
********************
* R       R        *
*    *  *  *       *
*  *R      H  * *  *
*  ** *    *       *
*  * R   *    *   **
*  *    * R *    R *
*      *     **    *
* R   R   *     R  *
********************