13x29
*****************************
* R               R         *
*  **+       +              *
*   R      H    *       R   *
*     +    +   ****        +*
*    R ***             R    *
*     **   R      R         *
*              ***          *
* R   R         R     +     *
*          +             R  *
*    R     ***        R     *
*             R  R          *
***************O*************
